{
  "tileTypes": {
    "0": {
      "name": "Healthy",
      "color": "#DDBB99",
      "description": "Healthy tissue"
    },
    "1": {
      "name": "Minor Damage",
      "color": "#CC9988",
      "description": "Minor tissue damage"
    },
    "2": {
      "name": "Moderate Damage",
      "color": "#bb7f77",
      "description": "Moderate tissue damage"
    },
    "3": {
      "name": "Severe Damage",
      "color": "#cc352b",
      "description": "Severe tissue damage"
    },
    "4": {
      "name": "Medicine Pill",
      "color": "#f9cc6c",
      "description": "Fuel restoration pill"
    }
  },
  "levels": [
    {
      "name": "Zit",
      "fuelLimit": 25,
      "grid": [
        0, 0, 0, 0, 0, 0, 0, 0, 0, 0,
        0, 0, 0, 0, 0, 0, 0, 0, 0, 0,
        0, 0, 0, 0, 0, 0, 0, 0, 0, 0,
        0, 0, 0, 0, 1, 0, 0, 0, 0, 0,
        0, 0, 0, 1, 2, 1, 0, 0, 0, 0,
        0, 0, 0, 1, 3, 1, 0, 0, 0, 0,
        0, 0, 0, 1, 2, 1, 0, 0, 0, 0,
        0, 0, 0, 0, 1, 0, 4, 0, 0, 0,
        0, 0, 0, 0, 0, 0, 0, 0, 4, 0,
        0, 0, 0, 0, 0, 0, 0, 0, 0, 0
      ]
    },
    {
      "name": "First Challenge",
      "fuelLimit": 200,
      "grid": [
        0, 0, 0, 0, 0, 0, 0, 0, 0, 0,
        0, 1, 1, 1, 0, 0, 1, 1, 1, 0,
        0, 1, 0, 1, 0, 0, 1, 2, 1, 0,
        0, 1, 1, 1, 0, 0, 1, 1, 1, 0,
        0, 0, 0, 0, 0, 0, 0, 0, 0, 0,
        0, 0, 0, 0, 4, 4, 0, 0, 0, 0,
        0, 2, 2, 2, 0, 0, 1, 1, 1, 0,
        0, 2, 1, 2, 0, 0, 1, 3, 1, 0,
        0, 2, 2, 2, 0, 0, 1, 1, 1, 0,
        0, 0, 0, 0, 0, 0, 0, 0, 0, 0
      ]
    },
    {
      "name": "Infection Spread",
      "fuelLimit": 200,
      "grid": [
        0, 0, 0, 0, 0, 0, 0, 0, 0, 0,
        0, 0, 1, 2, 3, 3, 2, 1, 0, 0,
        0, 1, 2, 3, 3, 3, 3, 2, 1, 0,
        0, 2, 3, 0, 3, 3, 0, 3, 2, 0,
        0, 3, 3, 3, 4, 4, 3, 3, 3, 0,
        0, 3, 3, 3, 4, 4, 3, 3, 3, 0,
        0, 2, 3, 0, 3, 3, 0, 3, 2, 0,
        0, 1, 2, 3, 3, 3, 3, 2, 1, 0,
        0, 0, 1, 2, 3, 3, 2, 1, 0, 0,
        0, 0, 0, 0, 0, 0, 0, 0, 0, 0
      ]
    },
    {
      "name": "Scattered Wounds",
      "fuelLimit": 200,
      "grid": [
        1, 0, 0, 2, 0, 0, 2, 0, 0, 1,
        0, 0, 0, 0, 0, 0, 0, 0, 0, 0,
        0, 0, 3, 0, 0, 0, 0, 3, 0, 0,
        2, 0, 0, 0, 4, 4, 0, 0, 0, 2,
        0, 0, 0, 4, 0, 0, 4, 0, 0, 0,
        0, 0, 0, 4, 0, 0, 4, 0, 0, 0,
        2, 0, 0, 0, 4, 4, 0, 0, 0, 2,
        0, 0, 3, 0, 0, 0, 0, 3, 0, 0,
        0, 0, 0, 0, 0, 0, 0, 0, 0, 0,
        1, 0, 0, 2, 0, 0, 2, 0, 0, 1
      ]
    },
    {
      "name": "Critical Condition",
      "fuelLimit": 200,
      "grid": [
        3, 3, 2, 1, 0, 0, 1, 2, 3, 3,
        3, 2, 1, 0, 0, 0, 0, 1, 2, 3,
        2, 1, 0, 0, 4, 4, 0, 0, 1, 2,
        1, 0, 0, 0, 3, 3, 0, 0, 0, 1,
        0, 0, 4, 3, 3, 3, 3, 4, 0, 0,
        0, 0, 4, 3, 3, 3, 3, 4, 0, 0,
        1, 0, 0, 0, 3, 3, 0, 0, 0, 1,
        2, 1, 0, 0, 4, 4, 0, 0, 1, 2,
        3, 2, 1, 0, 0, 0, 0, 1, 2, 3,
        3, 3, 2, 1, 0, 0, 1, 2, 3, 3
      ]
    }
  ]
}