{
  "levels": [
    {
      "name": "Tutorial",
      "fuelLimit": 25,
      "grid": [
        0, 0, 0, 0, 0, 0, 0, 0, 0, 0,
        0, 0, 0, 0, 0, 0, 0, 0, 0, 0,
        0, 0, 0, 0, 0, 0, 0, 0, 0, 0,
        0, 0, 0, 0, 1, 0, 0, 0, 0, 0,
        0, 0, 0, 1, 2, 1, 0, 0, 0, 0,
        0, 0, 0, 1, 3, 1, 0, 0, 0, 0,
        0, 0, 0, 1, 2, 1, 0, 0, 0, 0,
        0, 0, 0, 0, 1, 0, 4, 0, 0, 0,
        0, 0, 0, 0, 0, 0, 0, 0, 4, 0,
        0, 0, 0, 0, 0, 0, 0, 0, 0, 0
      ]
    },
    {
      "name": "First Challenge",
      "fuelLimit": 230,
      "grid": [
        0, 0, 0, 0, 0, 0, 0, 0, 0, 0,
        0, 1, 1, 1, 0, 0, 1, 1, 1, 0,
        0, 1, 2, 1, 0, 0, 1, 2, 1, 0,
        0, 1, 1, 1, 0, 0, 1, 1, 1, 0,
        0, 0, 0, 0, 0, 0, 0, 0, 0, 0,
        0, 0, 0, 0, 4, 4, 0, 0, 0, 0,
        0, 1, 1, 1, 0, 0, 1, 1, 1, 0,
        0, 1, 3, 1, 0, 0, 1, 3, 1, 0,
        0, 1, 1, 1, 0, 0, 1, 1, 1, 0,
        0, 0, 0, 0, 0, 0, 0, 0, 0, 0
      ]
    },
    {
      "name": "Infection Spread",
      "fuelLimit": 248,
      "grid": [
        0, 0, 0, 0, 0, 0, 0, 0, 0, 0,
        0, 0, 1, 2, 3, 3, 2, 1, 0, 0,
        0, 1, 2, 3, 3, 3, 3, 2, 1, 0,
        0, 2, 3, 3, 3, 3, 3, 3, 2, 0,
        0, 3, 3, 3, 4, 4, 3, 3, 3, 0,
        0, 3, 3, 3, 4, 4, 3, 3, 3, 0,
        0, 2, 3, 3, 3, 3, 3, 3, 2, 0,
        0, 1, 2, 3, 3, 3, 3, 2, 1, 0,
        0, 0, 1, 2, 3, 3, 2, 1, 0, 0,
        0, 0, 0, 0, 0, 0, 0, 0, 0, 0
      ]
    },
    {
      "name": "Scattered Wounds",
      "fuelLimit": 256,
      "grid": [
        1, 0, 0, 2, 0, 0, 2, 0, 0, 1,
        0, 0, 0, 0, 0, 0, 0, 0, 0, 0,
        0, 0, 3, 0, 0, 0, 0, 3, 0, 0,
        2, 0, 0, 0, 4, 4, 0, 0, 0, 2,
        0, 0, 0, 4, 0, 0, 4, 0, 0, 0,
        0, 0, 0, 4, 0, 0, 4, 0, 0, 0,
        2, 0, 0, 0, 4, 4, 0, 0, 0, 2,
        0, 0, 3, 0, 0, 0, 0, 3, 0, 0,
        0, 0, 0, 0, 0, 0, 0, 0, 0, 0,
        1, 0, 0, 2, 0, 0, 2, 0, 0, 1
      ]
    },
    {
      "name": "Critical Condition",
      "fuelLimit": 264,
      "grid": [
        3, 3, 2, 1, 0, 0, 1, 2, 3, 3,
        3, 2, 1, 0, 0, 0, 0, 1, 2, 3,
        2, 1, 0, 0, 4, 4, 0, 0, 1, 2,
        1, 0, 0, 4, 3, 3, 4, 0, 0, 1,
        0, 0, 4, 3, 3, 3, 3, 4, 0, 0,
        0, 0, 4, 3, 3, 3, 3, 4, 0, 0,
        1, 0, 0, 4, 3, 3, 4, 0, 0, 1,
        2, 1, 0, 0, 4, 4, 0, 0, 1, 2,
        3, 2, 1, 0, 0, 0, 0, 1, 2, 3,
        3, 3, 2, 1, 0, 0, 1, 2, 3, 3
      ]
    }
  ]
}